R  1200 800

NO ./textures/brick.xpm
SO ./textures/blue.xpm
WE ./textures/wood.xpm     
EA ./textures/grey.xpm

S  ./textures/chalice.xpm

F  255,172,105
C  205,249,222

        1111111111111111111111111
        1000000000110000000000001
        111100000111000N002000001
        1011000000000000000000001
111111111111000001110000000000001
100000000011000001110111110111111
11110111111111011100000010001
11110111111111011101010010001
11000000110101011100000010001
10002000000000001100000010001
10000000000000001101010010001
1100000111010101111101111000111
11110111 1110101 101111010001
11111111 1111111 111111111111
