R  1080 720

NO ./textures/brick.xpm
SO ./textures/blue.xpm
WE ./textures/wood.xpm     
EA ./textures/grey.xpm

S  ./textures/chalice.xpm

F  255,172,105
C  205,249,255

        1111111111111111111111111
        1000000000110000000000001
        1011000001110000002000E01
        1001000000000000000000001
        1111111111111111111111111

