R  1080 720

NO ./textures/brick.xpm
SO ./textures/blue.xpm
WE ./textures/wood.xpm     
EA ./textures/grey.xpm

S  ./textures/chalice.xpm

F  255,172,105
C  205,249,255

 	    1111111111111111111111111
    	1000000000110000000000001
        1011000001110000002000001
        1001000000000000000000001
111111111011000001110000000000001
100000000011000001110111111111101
1110111111111011100000010001
1110111111111011101010010001
11000000110101011100000010001
10002000000000001100000010001
10000000000000001101010010001
11000001110101011111011110N0111
11110111 1110101 101111010001
11111111 1111111 111111111111
